H.##......
#.##..###.
#.###.###.
#.....###.
###.#####O