S.##.....T
#.##..###.
#.###E###E
#.E...###.
###T#####G